abhaygojiya = abhaygojiya <abhaygojiya@matrixcomsec.com>
amishapatel = amishapatel <amishapatel@matrixcomsec.com>
ankitsohaliya = ankitsohaliya <ankitsohaliya@matrixcomsec.com>
ashvingodhaniya = ashvingodhaniya <ashvingodhaniya@matrixcomsec.com>
ayushsavaliya = ayushsavaliya <ayushsavaliya@matrixcomsec.com>
bharatgohil = bharatgohil <bharatgohil@matrixcomsec.com>
bhavinpanara = bhavinpanara <bhavinpanara@matrixcomsec.com>
chayandashora = chayandashora <chayandashora@matrixcomsec.com>
chiragpatwari = chiragpatwari <chiragpatwari@matrixcomsec.com>
chiragprajapati = chiragprajapati <chiragprajapati@matrixcomsec.com>
darshanjasanee = darshanjasanee <darshanjasanee@matrixcomsec.com>
darshanpatel = darshanpatel <darshanpatel@matrixcomsec.com>
deeppadmani = deeppadmani <deeppadmani@matrixcomsec.com>
devendrasinhchauhan = devendrasinhchauhan <devendrasinhchauhan@matrixcomsec.com>
dharmendramaurya = dharmendramaurya <dharmendramaurya@matrixcomsec.com>
dineshkanth = dineshkanth <dineshkanth@matrixcomsec.com>
divyeshmaisuria = divyeshmaisuria <divyeshmaisuria@matrixcomsec.com>
hardikpatel = hardikpatel <hardikpatel@matrixcomsec.com>
hemangimehta = hemangimehta <hemangimehta@matrixcomsec.com>
hiralkalavadiya = hiralkalavadiya <hiralkalavadiya@matrixcomsec.com>
jaldeepkaneria = jaldeepkaneria <jaldeepkaneria@matrixcomsec.com>
jaydeepfaldu = jaydeepfaldu <jaydeepfaldu@matrixcomsec.com>
jaydesai = jaydesai <jaydesai@matrixcomsec.com>
jaydevsinhjadeja = jaydevsinhjadeja <jaydevsinhjadeja@matrixcomsec.com>
kaivalshah = kaivalshah <kaivalshah@matrixcomsec.com>
kalpeshparmar = kalpeshparmar <kalpeshparmar@matrixcomsec.com>
ketulbhavsar = ketulbhavsar <ketulbhavsar@matrixcomsec.com>
khushboosingh = khushboosingh <khushboosingh@matrixcomsec.com>
kinjalsojitra = kinjalsojitra <kinjalsojitra@matrixcomsec.com>
krutikpatel = krutikpatel <krutikpatel@matrixcomsec.com>
kuldipgor = kuldipgor <kuldipgor@matrixcomsec.com>
kuldipkanzariya = kuldipkanzariya <kuldipkanzariya@matrixcomsec.com>
manishchandra = manishchandra <manishchandra@matrixcomsec.com>
meetbariya = meetbariya <meetbariya@matrixcomsec.com>
meghanachangrani = meghanachangrani <meghanachangrani@matrixcomsec.com>
mitinkumarmahto = mitinkumarmahto <mitinkumarmahto@matrixcomsec.com>
mohananaresh = mohananaresh <mohananaresh@matrixcomsec.com>
mukeshpareek = mukeshpareek <mukeshpareek@matrixcomsec.com>
naimeshchokhawala = naimeshchokhawala <naimeshchokhawala@matrixcomsec.com>
nandanibhardwaj = nandanibhardwaj <nandanibhardwaj@matrixcomsec.com>
neeldharsandiya = neeldharsandiya <neeldharsandiya@matrixcomsec.com>
nikhilkale = nikhilkale <nikhilkale@matrixcomsec.com>
nirajusadadiya = nirajusadadiya <nirajusadadiya@matrixcomsec.com>
nitishmehta = nitishmehta <nitishmehta@matrixcomsec.com>
parveenyadav = parveenyadav <parveenyadav@matrixcomsec.com>
prabhakarganduri = prabhakarganduri <prabhakarganduri@matrixcomsec.com>
prabhakar = prabhakar <prabhakar@matrixcomsec.com>
pramodrathod = pramodrathod <pramodrathod@matrixcomsec.com>
preritchoksi = preritchoksi <preritchoksi@matrixcomsec.com>
rahulpatel = rahulpatel <rahulpatel@matrixcomsec.com>
riddhipatel = riddhipatel <riddhipatel@matrixcomsec.com>
rikenprajapati = rikenprajapati <rikenprajapati@matrixcomsec.com>
rohitkhatri = rohitkhatri <rohitkhatri@matrixcomsec.com>
ronakgohel = ronakgohel <ronakgohel@matrixcomsec.com>
ronaktanna = ronaktanna <ronaktanna@matrixcomsec.com>
sachinsojitra = sachinsojitra <sachinsojitra@matrixcomsec.com>
savansutariya = savansutariya <savansutariya@matrixcomsec.com>
shubhamgarsole = shubhamgarsole <shubhamgarsole@matrixcomsec.com>
shubhamsoni = shubhamsoni <shubhamsoni@matrixcomsec.com>
sourabhkahalekar = sourabhkahalekar <sourabhkahalekar@matrixcomsec.com>
sureshkumar = sureshkumar <sureshkumar@matrixcomsec.com>
tejaspatel = tejaspatel <tejaspatel@matrixcomsec.com>
udaypodugu = udaypodugu <udaypodugu@matrixcomsec.com>
upendragupt = upendragupt <upendragupt@matrixcomsec.com>
vaibhavdarji = vaibhavdarji <vaibhavdarji@matrixcomsec.com>
vasimkhatri = vasimkhatri <vasimkhatri@matrixcomsec.com>
yashavadandalsaniya = yashavadandalsaniya <yashavadandalsaniya@matrixcomsec.com>
